[
  [ "eu", 0 ],
  [ "oc", 1 ],
  [ "af", 2 ],
  [ "as", 3 ],
  [ "na", 4 ],
  [ "sa", 5 ]
]
